NO textures/path.xpm
SO textures/path1.xpm 
WE textures/path2.xpm
EA textures/path3.xpm
F 120,70,30
C 200,200,200
11111111111111
10000000000001
10000010000001
10000101000001
10000010000001
10000000000N01
11111111111111